There are n_1 oak trees currently in the park. Park workers had to cut down n_2 oak trees that were damaged. How many oak trees will be in the park when the workers are finished?	X=n_1-n_2
Elisa has n_1 dollars. How many more dollars does she have to earn to have n_2 dollars?	X=n_2-n_1
Carla has some marbles. She bought n_1 marbles. Now she has n_2 marbles. How many did she start with?	X=n_2-n_1
Scott has n_1 tickets. Ernest has with n_2 tickets. Ernest finds another n_3. How many tickets does Ernest end with?	X=n_2+n_3
Joe had n_1 toy cars. If he gets n_2 more cars, how many cars will he have then?	X=n_1+n_2
There were originally n_1 apples in the jar. Debra removes n_2 apples from a jar. How many apples are left in the jar?	X=n_1-n_2
Larry starts with n_1 stickers. He loses n_2. How many stickers does Larry end with?	X=n_1-n_2
Mrs. Sheridan has n_1 cats. Mr. Sheridan gave her n_2 more cats. How many cats does Mrs. Sheridan have altogether?	X=n_1+n_2
Cheryl starts with n_1 Skittles. Kathryn gives Cheryl n_2 more. How many Skittles does Cheryl end with?	X=n_1+n_2
Steve has n_1 oranges. He shares n_2 with Patrick. How many oranges will Steve have?	X=n_1-n_2
n_1 children were riding on the bus. At the bus stop, some more children got on the bus. Then there were n_2 children altogether on the bus. How many children got on the bus at the bus stop?	X=n_1+n_2
There were originally n_1 eggs in the jar. David removes n_2 eggs from a jar. How many eggs are left in the jar?	X=n_1-n_2
Melissa has n_1 oranges. John takes n_2 away. How many oranges will Melissa have?	X=n_1-n_2
Hayley had n_1 meatballs on her plate. Kirsten stole some of her meatballs. Now she has n_2 meatballs on her plate. How many meatballs did Kirsten steal?	X=n_1-n_2
Jane starts with n_1 crayons. n_2 are eaten by a hippopotamus. How many crayons does Jane end with?	X=n_1-n_2
There are n_1 candies in a box. Lisa has n_2 candies in a bag. Diana takes n_3 candies out of the box. How many candies are left in the box?	X=n_1-n_3
Robin had n_1 pieces of gum. Her brother gave her some more pieces. Now Robin has n_2 pieces in all. How many pieces of gum did Robin's brother give her?	X=n_2-n_1
Pamela has n_1 Skittles. She gives n_2 to Karen. How many Skittles will Pamela have?	X=n_1-n_2
There were n_1 kids on the soccer field. n_2 kids decided to join in. Now how many kids are on the soccer field?	X=n_1+n_2
There are n_1 books on the shelf. Marta put n_2 more books on the shelf. How many books are on the shelf now?	X=n_1+n_2
There are n_1 candies in a pile on the desk. Each candy comes in a package of n_2. n_3 candies are added to the pile. How many candies are there in the pile?	X=n_1+n_3
Brenda has n_1 apples. She gets n_2 more from Willie. How many apples does Brenda have in all?	X=n_1+n_2
n_1 birds were sitting in a tree. n_2 more birds flew up to the tree. How many birds were there altogether in the tree?	X=n_1+n_2
David has n_1 bananas. He gets n_2 more from Christopher. Later, David buys n_3 cards at the store. How many bananas does David have in all?	X=n_1+n_2
Angela has n_1 tickets. Annie gives Angela n_2 more. How many tickets does Angela have in all?	X=n_1+n_2
There are n_1 pigs in the barn. Some more come to join them. Now there are n_2 pigs. How many pigs came to join them?	X=n_2-n_1
Sarah had some trucks. She gave n_1 to Jeff, and now she has n_2 trucks left. How many trucks did Sarah have to start with?	X=n_1+n_2
There are n_1 bananas in a pile on the desk. Each banana comes in a package of n_2. n_3 bananas are added to the pile. How many bananas are there in the pile?	X=n_1+n_3
Isabel bought n_1 pieces of paper. She used n_2 pieces of the paper. How many pieces of paper does she have left?	X=n_1-n_2
Larry starts with n_1 cards. n_2 are eaten by a hippopotamus. How many cards does Larry end with?	X=n_1-n_2
Connie had some marbles. She gave n_1 to Juan. Now she has n_2 marbles left. How many did she have to start with?	X=n_1+n_2
n_1 birds were sitting on the fence. n_2 more birds came to join them. How many birds are sitting on the fence?	X=n_1+n_2
There are n_1 cards. n_2 cards more are added. How many are there total?	X=n_1+n_2
Edward starts with n_1 eggs. He gives n_2 to Phillip. How many eggs does Edward end with?	X=n_1-n_2
Roger has n_1 blocks. n_2 are eaten by a hippopotamus. How many blocks will Roger have?	X=n_1-n_2
Mildred collects n_1 oranges. Mildred's father gives Mildred n_2 more. How many oranges does Mildred have?	X=n_1+n_2
n_1 ducks are swimming in a lake. n_2 more ducks come to join them. How many ducks are swimming in the lake?	X=n_1+n_2
Randy has n_1 blocks. He uses n_2 blocks to build a tower. How many blocks are left?	X=n_1-n_2
Mary starts with n_1 eggs. She finds another n_2. How many eggs does Mary end with?	X=n_1+n_2
Billy has n_1 crayons. n_2 are eaten by a hippopotamus. How many crayons will Billy have?	X=n_1-n_2
Isabella's hair is n_1 inches long. If she gets a haircut and now her hair is n_2 inches long, how much of Isabella's hair got cut off?	X=n_1-n_2
Jose starts with n_1 bottle caps. He gets n_2 more from Rebecca. How many bottle caps does Jose end with?	X=n_1+n_2
Martha starts with n_1 cards. She gets n_2 more from Emily. How many cards does Martha end with?	X=n_1+n_2
There are n_1 oranges in a box. Deborah has n_2 oranges in a bag. Susan takes n_3 oranges out of the box. How many oranges are left in the box?	X=n_1-n_3
Ruby has n_1 apples. Emily takes n_2 away. How many apples will Ruby have?	X=n_1-n_2
There are n_1 birds on the fence. n_2 more birds land on the fence. How many birds are on the fence?	X=n_1+n_2
Craig starts with n_1 Skittles. n_2 are eaten by a hippopotamus. How many Skittles does Craig end with?	X=n_1-n_2
Sean has n_1 blocks. n_2 are eaten by a hippopotamus. How many blocks will Sean have?	X=n_1-n_2
Patricia starts with n_1 candies. Albert takes n_2 away. How many candies does Patricia end with?	X=n_1-n_2
Our class got n_1 books from the library. Then we got n_2 more books from the library. How many books did our class get from the library?	X=n_1+n_2
Marie starts with n_1 erasers. She loses n_2. How many erasers does Marie end with?	X=n_1-n_2
Mikey had n_1 leaves. Some of her leaves blew away. Now she has n_2 leaves left. How many of her leaves blew away?	X=n_1-n_2
There are n_1 pencils in a box. Eric takes n_2 pencils. How many are left?	X=n_1-n_2
Charles has n_1 apples. Jessica gives Charles n_2 more. How many apples does Charles have in all?	X=n_1+n_2
William has n_1 marbles. He shares n_2 with Theresa. How many marbles will William have?	X=n_1-n_2
Teresa starts with n_1 bananas. She gets n_2 more from Rachel. How many bananas does Teresa end with?	X=n_1+n_2
n_1 birds were sitting in a tree. Some more fly up to the tree. Then there were n_2 birds in the tree. How many more fly up to the tree?	X=n_2-n_1
Nancy starts with n_1 bottle caps. She finds another n_2. How many bottle caps does Nancy end with?	X=n_1+n_2
Carol collects n_1 peanuts. Carol's father gives Carol n_2 more. How many peanuts does Carol have?	X=n_1+n_2
Anna collects n_1 blocks. Anna's father gives Anna n_2 more. How many blocks does Anna have?	X=n_1+n_2
Craig has n_1 apples. Judy has n_2 apples. He shares n_3 with Eugene. How many apples will Craig have?	X=n_1-n_3
Clarence has n_1 tickets. He gives n_2 to Eugene. How many tickets will Clarence have?	X=n_1-n_2
Bobby collects n_1 blocks. Bobby's father gives Bobby n_2 more. How many blocks does Bobby have?	X=n_1+n_2
Ralph collects n_1 cards. Ralph's father gives Ralph n_2 more. How many cards does Ralph have?	X=n_1+n_2
If there are n_1 crayons in a box and Gerald puts n_2 more crayons inside, how many crayons are in the box?	X=n_1+n_2
There are n_1 marbles. n_2 marbles more are added. How many are there total?	X=n_1+n_2
n_1 beavers were working on their home. n_2 went for a swim. How many beavers are still working on their home?	X=n_1-n_2
After a party, n_1 of the cake is left over. That night, big brother eats n_2 of the cake. How much is left over after that?	X=n_1-n_2
n_1 children were riding on the bus. At the bus stop, some more children got on the bus. Then there were n_2 children altogether on the bus. How many children got on the bus at the bus stop?	X=n_2-n_1
Rosa had n_1 flowers. Andre gave her some more flowers. Now, Rosa has n_2 flowers. How many flowers did Andre give to Rosa?	X=n_2-n_1
Carlos starts with n_1 bananas. n_2 are eaten by a hippopotamus. How many bananas does Carlos end with?	X=n_1-n_2
Kelly has n_1 Nintendo games. How many does she need to give away so that she will have n_2 games left?	X=n_1-n_2
Willie starts with n_1 stickers. He gives n_2 to Emily. How many stickers does Willie end with?	X=n_1-n_2
There are n_1 blocks. n_2 blocks more are added. How many are there total?	X=n_1+n_2
Diane has n_1 crayons. She gets n_2 more from Frances. Later, Diane buys n_3 cards at the store. How many crayons does Diane have in all?	X=n_1+n_2
Lucy has an aquarium with n_1 fish. She wants to buy n_2 more fish. How many fish would Lucy have then?	X=n_1+n_2
Ernest starts with n_1 crayons. Jennifer takes n_2 away. How many crayons does Ernest end with?	X=n_1-n_2
Virginia starts with n_1 eggs. Amy takes n_2 away. How many eggs does Virginia end with?	X=n_1-n_2
Shelby's teacher gives out gold stars for great math work. Yesterday, Shelby earned n_1 gold stars. Today, she earned n_2 more. How many gold stars did Shelby earn in all?	X=n_1+n_2
Norma has n_1 cards. She loses n_2. How many cards will Norma have?	X=n_1-n_2
Kimberly has n_1 Skittles. She buys n_2 more. Later, Kimberly buys n_3 oranges at the store. How many Skittles does Kimberly have in all?	X=n_1+n_2
Janet has n_1 stickers. She gets n_2 more from Ruth. How many stickers does Janet have in all?	X=n_1+n_2
Carlos has n_1 blocks. He gives n_2 to Rachel. How many blocks will Carlos have?	X=n_1-n_2
Megan had n_1 markers. Robert gave her n_2 more markers. How many markers does Megan have altogether?	X=n_1+n_2
Nell collects baseball cards. She had n_1 cards. She gave some of her cards to Jeff and now has n_2 cards left. How many cards did Nell give to Jeff?	X=n_1-n_2
Isha's pencil is n_2 cubes long. If she gets another pencil that is n_2 cubes long, how many cubes long are both pencils?	X=n_2+n_2
If there are n_1 erasers in a box and Patrick puts n_2 more erasers inside, how many erasers are in the box?	X=n_1+n_2
There were originally n_1 pencils in the jar. Arthur removes n_2 pencils from a jar. How many pencils are left in the jar?	X=n_1-n_2
Carolyn starts with n_1 marbles and n_2 oranges. She shares n_3 with Diana. How many marbles does Carolyn end with?	X=n_1-n_3
The farmer had n_1 apples. He gave n_2 apples to his neighbor. How many apples does he have now?	X=n_1-n_2
Joyce starts with n_1 apples. She gives n_2 to Larry. How many apples does Joyce end with?	X=n_1-n_2
Sean has n_1 apples. Susan gives Sean n_2 more. Later, Sean buys n_3 tickets at the store. How many apples does Sean have in all?	X=n_1+n_2
There were originally n_1 bottle caps in the jar. Rachel removes n_2 bottle caps from a jar. How many bottle caps are left in the jar?	X=n_1-n_2
Eugene has n_1 pencils. He gets n_2 more from Joyce. How many pencils does Eugene have in all?	X=n_1+n_2
Wayne collects n_1 blocks. Wayne's father gives Wayne n_2 more. How many blocks does Wayne have?	X=n_1+n_2
There are n_1 apples in a pile on the desk. Each apple comes in a package of n_2. n_3 apples are added to the pile. How many apples are there in the pile?	X=n_1+n_3
Molly had n_1 candles on her birthday cake. She grew older and got n_2 more on her birthday cake. How old is Molly now?	X=n_1+n_2
Adolfo made a tower with n_1 blocks. He added some more blocks and now he has n_2 blocks. How many did he have to add?	X=n_2-n_1
Joshua has n_1 bottle caps. He buys n_2 more. How many bottle caps does Joshua have in all?	X=n_1+n_2
Evelyn starts with n_1 bottle caps. She finds another n_2. How many bottle caps does Evelyn end with?	X=n_1+n_2
Theresa has n_1 crayons. Janice has n_2 crayons. She shares n_3 with Nancy. How many crayons will Theresa have?	X=n_1-n_3
Willie has n_1 bananas. Charles has n_2 bananas. He loses n_3. How many bananas will Willie have?	X=n_1-n_3
There are n_1 bananas in a pile on the desk. Each banana comes in a package of n_2. n_3 bananas are added to the pile. How many bananas are there in the pile?	X=n_1+n_3
Paul had n_1 strawberries in his basket. He picked n_2 more strawberries. How many strawberries did he have then?	X=n_1+n_2
Mark has n_1 trees in his backyard. If he plants n_2 more, how many trees will he have?	X=n_1+n_2
Tommy had some balloons. His mom gave him n_1 more balloons for his birthday. Then, Tommy had n_2 balloons. How many balloons did Tommy have to start with?	X=n_2-n_1
Misha has n_1 dollars. How many more dollars does she have to earn to have n_2 dollars?	X=n_2-n_1
Charles has n_1 Skittles. Diana takes n_2 away. How many Skittles will Charles have?	X=n_1-n_2
Jesse starts with n_1 pencils. He gives n_2 to Joshua. How many pencils does Jesse end with?	X=n_1-n_2
Harry starts with n_1 apples. He buys n_2 more. How many apples does Harry end with?	X=n_1+n_2
n_1 toucans are sitting on a tree limb. n_2 more toucan joins them. How many toucans in all?	X=n_1+n_2
Shawn has n_1 blocks. Mildred has with n_2 blocks. Mildred finds another n_3. How many blocks does Mildred end with?	X=n_2+n_3
James had n_1 stickers. He got some more stickers for his birthday. Then he had n_2 stickers. How many stickers did James get for his birthday?	X=n_2-n_1
The clown blew up n_1 balloons. Then he blew up n_2 more balloons. How many balloons does the clown have now?	X=n_1+n_2
Adam has $n_1 to buy an airplane that costs $n_2. How much change will he get?	X=n_1-n_2
Misha has n_1 dollars. How many dollars does she have to earn to have n_2 dollars to buy a dog?	X=n_2-n_1
There are n_1 apples in a box. Louise has n_2 apples in a bag. Scott takes n_3 apples out of the box. How many apples are left in the box?	X=n_1-n_3
Bruce has n_1 eggs. Kimberly has n_2 eggs. He loses n_3. How many eggs will Bruce have?	X=n_1-n_3
Mrs. Franklin had n_1 Valentines. Mrs. Franklin gave some to her students. Now she has n_2. How many Valentines did Mrs. Franklin give to her students?	X=n_1-n_2
William starts with n_1 tickets. He buys n_2 more. How many tickets does William end with?	X=n_1+n_2
Peter starts with n_1 erasers. Bridget gives Peter n_2 more. How many erasers does Peter end with?	X=n_1+n_2
Joyce has n_1 eggs. Marie gives Joyce n_2 more. Later, Joyce buys n_3 erasers at the store. How many eggs does Joyce have in all?	X=n_1+n_2
Josh had n_1 marbles in his collection. He lost n_2 marbles. How many marbles does he have now?	X=n_1-n_2
n_1 birds were sitting in a tree. Some more fly up to the tree. Then there were n_2 birds in the tree. How many more flew up to the tree?	X=n_2-n_1
Anthony has n_1 pencils. Kathryn gives Anthony n_2 more. How many pencils does Anthony have in all?	X=n_1+n_2
My dog had some bones. Then, he dug up n_1 bones. Now he has n_2 bones. How many bones did he start with?	X=n_2-n_1
Joseph has n_1 candies. Kathy gives Joseph n_2 more. How many candies does Joseph have in all?	X=n_1+n_2
Albert has n_1 bottle caps. Anne has with n_2 bottle caps. Anne finds another n_3. How many bottle caps does Anne end with?	X=n_2+n_3
Anna starts with n_1 candies. She gets n_2 more from Larry. How many candies does Anna end with?	X=n_1+n_2
There were originally n_1 bananas in the jar. Denise removes n_2 bananas from a jar. How many bananas are left in the jar?	X=n_1-n_2
Wanda has n_1 blocks. Theresa gives Wanda n_2 more. How many blocks does Wanda have in all?	X=n_1+n_2
Barbara has n_1 candies. She buys n_2 more. How many candies does Barbara have in all?	X=n_1+n_2
Heather starts with n_1 blocks. She shares n_2 with Jose. How many blocks does Heather end with?	X=n_1-n_2
There are n_1 bottle caps in a box. Marvin takes n_2 bottle caps. How many are left?	X=n_1-n_2
Larry has n_1 cards. Dennis takes n_2 away. How many cards will Larry have?	X=n_1-n_2
n_1 birds were sitting in a tree. n_2 more birds flew up to the tree. How many birds were there altogether in the tree?	X=n_1+n_2
Norma starts with n_1 bananas. She loses n_2. How many bananas does Norma end with?	X=n_1-n_2
Carla has some marbles. She bought n_1 marbles. Now she has n_2 marbles all together. How many did she start with?	X=n_2-n_1
Marilyn starts with n_1 bottle caps. She shares n_2 with Nancy. How many bottle caps does Marilyn end with?	X=n_1-n_2
Carol starts with n_1 blocks. She loses n_2. How many blocks does Carol end with?	X=n_1-n_2
Dorothy has n_1 cards. She gives n_2 to Harold. How many cards will Dorothy have?	X=n_1-n_2
Mrs. Hilt had n_1 cents. She bought a pencil for n_2 cents. How much money did she have left?	X=n_1-n_2
Bobby ate n_1 pieces of candy. Then, he ate n_2 more. How many pieces of candy did Bobby eat?	X=n_1+n_2
Kevin starts with n_1 cards. He finds another n_2. How many cards does Kevin end with?	X=n_1+n_2
Jennifer starts with n_1 apples. She finds another n_2. How many apples does Jennifer end with?	X=n_1+n_2
William has n_1 bottle caps. He buys n_2 more. How many bottle caps does William have in all?	X=n_1+n_2
There are n_1 oranges in a box. Jonathan takes n_2 oranges. How many are left?	X=n_1-n_2
There are n_1 eggs in a box. Harry takes n_2 eggs. How many are left?	X=n_1-n_2
Arthur has n_1 cards. Aaron has with n_2 cards. Aaron finds another n_3. How many cards does Aaron end with?	X=n_2+n_3
Jorge scored n_1 goals playing soccer last season. This season he scored n_2 goals. What is the total number of goals Jorge scored?	X=n_1+n_2
Mrs. Wong had n_1 Valentines. She gave n_2 Valentines to her children. How many does she have left?	X=n_1-n_2
If there are n_2 bottle caps in a box and Linda puts n_2 more bottle caps inside, how many bottle caps are in the box?	X=n_2+n_2
Carson's teacher gives out gold stars for great math work. Yesterday, Carson earned n_1 gold stars. Today, he earned n_2 more. How many gold stars did Carson earn in all?	X=n_1+n_2
There are n_1 oranges in a box. Paula takes n_2 oranges. How many are left?	X=n_1-n_2
On the first day of the week Pat had n_1 stickers. Pat earned n_2 more during the week. How many stickers did Pat have at the end of the week?	X=n_1+n_2
Kenneth has n_1 marbles. He buys n_2 more. Later, Kenneth buys n_3 apples at the store. How many marbles does Kenneth have in all?	X=n_1+n_2
n_1 boys went down the slide. n_2 more boys went down the slide. How many boys went down the slide?	X=n_1+n_2
William has n_1 bottle caps. He buys n_2 more. How many bottle caps does William have in all?	X=n_1+n_2
There are n_1 apples in a pile on the desk. Each apple comes in a package of n_2. n_3 apples are added to the pile. How many apples are there in the pile?	X=n_1+n_3
Gary had n_1 dollars. He spent n_2 dollars on a pet snake. How many dollars did Gary have left?	X=n_1-n_2
n_1 dogs are barking. n_2 more dogs start to bark. How many dogs are barking?	X=n_1+n_2
Kimberly has n_1 Skittles. She buys n_2 more. Later, Kimberly buys n_3 oranges at the store. How many Skittles does Kimberly have in all?	X=n_1+n_2
There are n_2 oranges. n_2 oranges more are added. How many are there total?	X=n_2+n_2
Todd has some gum. Steve gave him n_1 more pieces of gum. Now Todd has n_2 pieces of gum. How many pieces did Todd have to start with?	X=n_2-n_1
Sarah has n_1 bottle caps. She buys n_2 more. How many bottle caps does Sarah have in all?	X=n_1+n_2
There are n_1 cards. n_2 cards more are added. How many are there total?	X=n_1+n_2
Emily collects n_1 cards. Emily's father gives Emily n_2 more. Bruce has n_3 apples. How many cards does Emily have?	X=n_1+n_2
Mrs. Sheridan has n_1 fish. Her sister gave her n_2 more fish. How many fish does she have now?	X=n_1+n_2
Kelly has n_1 Nintendo games. How many does she need to give away so that she will have n_2 games left?	X=n_1-n_2
Tim had n_1 cents. He paid n_2 cents for a candy bar. How much change will he get?	X=n_1-n_2
Brian has n_1 cards. Wayne takes n_2 away. How many cards will Brian have?	X=n_1-n_2
Annie starts with n_1 crayons. Matthew gives Annie n_2 more. How many crayons does Annie end with?	X=n_1+n_2
Isabella's hair is n_1 inches long. By the end of the year her hair is n_2 inches long. How much hair did she grow?	X=n_2-n_1
Megan has n_1 seashells. How many more seashells does she need to find to have n_2 seashells in her collection?	X=n_2-n_1
If there are n_1 eggs in a box and Daniel puts n_2 more eggs inside, how many eggs are in the box?	X=n_1+n_2
Lucy has n_1 fish. How many more fish does she need to buy to have n_2 fish?	X=n_2-n_1
If there are n_1 bottle caps in a box and Linda puts n_2 more bottle caps inside, how many bottle caps are in the box?	X=n_1+n_2
Aaron starts with n_1 erasers. He gives n_2 to Doris. How many erasers does Aaron end with?	X=n_1-n_2
Brandon has n_1 Skittles. Bonnie has n_2 Skittles. He loses n_3. How many Skittles will Brandon have?	X=n_1-n_3
Tina has n_1 bananas. She gets n_2 more from Joyce. How many bananas does Tina have in all?	X=n_1+n_2
There are n_1 erasers in a box. Ernest has n_2 erasers in a bag. Mark takes n_3 erasers out of the box. How many erasers are left in the box?	X=n_1-n_3
Clarence has n_1 oranges. He gets n_2 more from Joyce. Later, Clarence buys n_3 Skittles at the store. How many oranges does Clarence have in all?	X=n_1+n_2
Nicholas starts with n_1 bottle caps. He gets n_2 more from Catherine. How many bottle caps does Nicholas end with?	X=n_1+n_2
Lisa starts with n_1 bananas. Maria gives Lisa n_2 more. How many bananas does Lisa end with?	X=n_1+n_2
Pamela starts with n_1 bottle caps. Jean takes n_2 away. How many bottle caps does Pamela end with?	X=n_1-n_2
Isabella's hair is n_1 cubes long. If her hair grows n_2 more inches, how long will it be?	X=n_1+n_2
Josh had n_1 pencils. He gave n_2 pencils to Dorothy. How many pencils does Josh have left?	X=n_1-n_2
Katherine has n_1 bottle caps. n_2 are eaten by a hippopotamus. How many bottle caps will Katherine have?	X=n_1-n_2
Connie had some marbles. She gave n_1 to Juan. Now she has n_2 marbles left. How many did she have to start with?	X=n_1+n_2
Janet has n_1 apples. She finds another n_2. How many apples does Janet have in all?	X=n_1+n_2
Jovana had n_1 pounds of shells in her bucket. She added some shells and now has n_2 pounds of shells. How many pounds did she add?	X=n_2-n_1
Cade had n_1 marbles. He gave n_2 to Dylan. How many does he have left?	X=n_1-n_2
Helen starts with n_1 cards. Gary takes n_2 away. How many cards does Helen end with?	X=n_1-n_2
There are n_1 walnut trees currently in the park. Park workers will plant n_2 walnut trees today. How many walnut trees will the park have when the workers are finished?	X=n_1+n_2
Sam had n_1 dimes in his bank. His dad gave him n_2 dimes. How many dimes does Sam have now?	X=n_1+n_2
Alyssa's dog had puppies. She gave n_1 to her friends. She now has n_2 puppies. How many puppies did she have to start with?	X=n_1+n_2
There are n_1 pencils in the drawer. Tim placed n_2 pencils in the drawer. How many pencils are now there in total?	X=n_1+n_2
There are n_1 rulers. There are n_2 crayons in the drawer. Tim placed n_3 rulers in the drawer. How many rulers are now there in all?	X=n_1+n_3
Jason had n_1 quarters in his bank. His dad gave him n_2 quarters. How many quarters does he have now?	X=n_1+n_2
There are n_1 pencils. There are n_2 crayons in the drawer. Joan placed n_3 pencils in the drawer. How many pencils are now there in total?	X=n_1+n_3
There are n_1 walnut trees currently in the park. Park workers will plant n_2 walnut trees today. How many walnut trees will the park have when the workers are finished?	X=n_1+n_2
Sara had n_1 quarters in her bank. Her dad gave her n_2 quarters. How many quarters does she have now?	X=n_1+n_2	
There are n_1 pencils in the drawer. Mike placed n_2 pencils in the drawer. How many pencils are now there in total?	X=n_1+n_2
Mike has n_1 books in his library. He bought several books at a yard sale over the weekend. He now has n_2 books in his library. How many books did he buy at the yard sale?	X=n_2-n_1
There are n_1 maple trees currently in the park. Park workers will plant maple trees today. When the workers are finished there will be n_2 maple trees in the park. How many maple trees did the workers plant today?	X=n_2-n_1
Dan found n_1 seashells on the beach. He gave Jessica some of his seashells. He has n_2 seashell. How many seashells did he give to Jessica?	X=n_1-n_2
Sally had n_1 peaches at her roadside fruit dish. She went to the orchard and picked peaches to stock up. There are now n_2 peaches. How many did she pick?	X=n_2-n_1
There were n_1 roses in the vase. Alyssa cut some roses from her flower garden. There are now n_2 roses in the vase. How many roses did she cut?	X=n_2-n_1
Last week Tom had n_1 dollars. He washed cars over the weekend. He now has n_2 dollars. How much money did he make washing cars?	X=n_2-n_1
There were n_1 bales of hay in the barn. Jason stacked bales in the barn today. There are now n_2 bales of hay in the barn. How many bales did he store in the barn?	X=n_2-n_1
There are n_1 crayons in the drawer. Benny placed n_2 crayons in the drawer. How many crayons are now there in total?	X=n_1+n_2
There are n_1 oak trees currently in the park. Park workers will plant n_2 oak trees today. How many oak trees will the park have when the workers are finished?	X=n_1+n_2
Tom found n_1 seashells. n_2 were broken. How many unbroken seashells did Tom find?	X=n_1-n_2
Joan has n_1 orange balloons. She lost n_2 of them. How many orange balloons does Joan have now?	X=n_1-n_2
Fred had n_1 dimes in his bank. His sister borrowed n_2 of his dimes. How many dimes does Fred have now?	X=n_1-n_2
Joan's cat had n_1 kittens. She gave n_2 to her friends. How many kittens does she have now?	X=n_1-n_2
There are n_1 dogwood trees currently in the park. Park workers will plant n_2 dogwood trees today. How many dogwood trees will the park have when the workers are finished?	X=n_1+n_2
There are n_1 pencils in the drawer. Nancy placed n_2 pencils in the drawer. How many pencils are now there in total?	X=n_1+n_2
Sam found n_1 seashells on the beach. He gave Joan n_2 of the seashells. How many seashells does he now have?	X=n_1-n_2
Mike has n_1 baseball cards. Sam bought n_2 of Mike's baseball cards. How many baseball cards does Mike have now?	X=n_1-n_2
There are n_1 scissors in the drawer. Keith placed n_2 scissors in the drawer. How many scissors are now there in all?	X=n_1+n_2
Sam had n_1 pennies in his bank. He spent n_2 of his pennies. How many pennies does he have now?	X=n_1-n_2
Joan found n_1 seashells on the beach. She gave Mike n_2 of the seashells. How many seashells does she now have?	X=n_1-n_2
Sally had n_1 quarters in her bank. She spent n_2 of her quarters. How many quarters does she have now?	X=n_1-n_2
Jason has n_1 Pokemon cards. Alyssa bought n_2 of Jason's Pokemon cards. How many Pokemon cards does Jason have now?	X=n_1-n_2
There are n_1 walnut trees currently in the park. Park workers will plant n_2 walnut trees today. How many walnut trees will the park have when the workers are finished?	X=n_1+n_2
Fred has n_1 green balloons. He gave Sandy n_2 of the balloons. How many green balloons does he now have?	X=n_1-n_2
There are n_1 pencils in the drawer. Sara placed n_2 pencils in the drawer. How many pencils are now there in all?	X=n_1+n_2
Jason has n_1 Pokemon cards. Benny bought n_2 of Jason's Pokemon cards. How many Pokemon cards does Jason have now?	X=n_1-n_2
Mike has n_1 orange marbles. He gave Sam n_2 of the marbles. How many orange marbles does he now have?	X=n_1-n_2
Joan had n_1 dimes in her bank. She spent n_2 of her dimes. How many dimes does she have now?	X=n_1-n_2
There are n_1 orchid bushes currently in the park. Park workers will plant n_2 orchid bushes today. How many orchid bushes will the park have when the workers are finished?	X=n_1+n_2
Sam grew n_1 watermelons. The rabbits ate n_2 watermelons. How many watermelons does Sam have?	X=n_1-n_2
Mary had n_1 nickels in her bank. Her dad gave her n_2 nickels. How many nickels does Mary have now?	X=n_1+n_2
Tom found n_1 seashells on the beach. He gave Jessica n_2 of the seashells. How many seashells does he now have?	X=n_1-n_2
Fred has n_1 baseball cards. Melanie bought n_2 of Fred's baseball cards. How many baseball cards does Fred have now?	X=n_1-n_2
There are n_1 oak trees currently in the park. Park workers had to cut down n_2 oak trees that were damaged. How many oak trees will the park have when the workers are finished?	X=n_1-n_2
Jessica had n_1 quarters in her bank. Her sister borrowed n_2 of her quarters. How many quarters does Jessica have now?	X=n_1-n_2
A restaurant made n_1 hamburgers to serve during lunch. Only n_2 were actually served. How many hamburgers were over from lunch?	X=n_1-n_2
There are n_1 crayons in the drawer. Mary took n_2 crayons out of the drawer. How many crayons are there now?	X=n_1-n_2
Dan picked n_1 limes. He gave Sara n_2 of the limes. How many limes does Dan have now?	X=n_1-n_2
Joan has n_1 blue balloons. She lost n_2 of them. How many blue balloons does Joan have now?	X=n_1-n_2
Joan picked n_1 apples from the orchard. She gave n_2 apples to Melanie. How many apples does Joan have now?	X=n_1-n_2
Tom has n_1 violet balloons. He gave Fred n_2 of the balloons. How many violet balloons does he now have?	X=n_1-n_2
Fred has n_1 baseball cards. Keith bought n_2 of Fred 's baseball cards. How many baseball cards does Fred have now?	X=n_1-n_2
Fred found n_1 seashells on the beach. He gave Jessica n_2 of the seashells. How many seashells does he now have?	X=n_1-n_2
Sara grew n_1 pumpkins. The rabbits ate n_2 pumpkins. How many pumpkins does Sara have?	X=n_1-n_2
Joan decided to sell all of her old books. She gathered up n_1 books to sell. She sold n_2 books in a yard sale. How many books does Joan now have?	X=n_1-n_2
There are n_1 rulers in the drawer. Tim took n_2 rulers from the drawer. How many rulers are now in the drawer?	X=n_1-n_2
